XXXXXXXXXXXXXXXXXXXXXXXXXXXXXXXXXXXXXXXXXXXXXX
XS X        X        X           X           X
X  X  XXXX  X  XXXX  XXXXXXXXXX  X  XXXXXXX  X
X     X     X     X     X     X        X     X
XXXXXXX  XXXXXXX  X  X  X  X  XXXXXXX  X  XXXX
X     X     X     X  X  X  X  X        X     X
X  XXXXXXX  XXXXXXXXXX  X  X  X  XXXXXXXXXX  X
X                       X  X  X  X     X     X
XXXXXXXXXX  XXXXXXXXXXXXX  X  X  X  X  XXXXXXX
X           X           X  X     X  X     X  X
X  XXXXXXXXXX  XXXXXXX  X  XXXXXXX  XXXX  X  X
X  X        X  X     X  X     X  X  X     X  X
X  X  X  X  X  X  X  X  XXXX  X  X  X  XXXX  X
X  X  X  X  X     X  X     X  X     X     X  X
X  X  X  XXXXXXXXXX  X  X  X  X  XXXXXXX  X  X
X  X  X  X     X     X  X     X  X        X  X
X  X  X  X  X  XXXXXXX  XXXX  X  X  XXXXXXX  X
X     X     X  X     X     X     X        X  X
XXXXXXXXXXXXX  X  X  X  XXXXXXXXXXXXXXXX  X  X
X  X        X     X  X  X     X           X  X
X  X  XXXXXXXXXXXXX  X  X  X  XXXXXXXXXX  X  X
X  X        X     X        X  X     X     X  X
X  XXXXXXX  XXXX  XXXXXXXXXX  X  X  X  XXXX  X
X     X        X           X  X  X        X  X
XXXX  XXXXXXX  XXXX  XXXX  XXXX  X  XXXXXXX  X
X           X     X  X     X     X        X  X
X  XXXX  X  XXXX  XXXX  XXXX  XXXXXXXXXX  X  X
X  X     X     X     X  X     X        X     X
X  X  XXXXXXX  X  X  X  X  X  X  XXXX  XXXX  X
X  X        X     X        X  X     X       GX
XXXXXXXXXXXXXXXXXXXXXXXXXXXXXXXXXXXXXXXXXXXXXX